Prueba
6 9
######
#a** #
#a** #
#    #
#  b #
#    #
##--##
    ..
    ..
